落井下石	成语
画饼充饥	成语
虎头蛇尾	成语
泪流满面	成语
捧腹大笑	成语
画蛇添足	成语
一手遮天	成语
羊入虎口	成语
掩耳盗铃	成语
拔苗助长	成语
布娃娃	儿童玩具
恐龙	动物
蚂蚁	动物
蝴蝶	动物
熊猫	动物
蝎子	动物
孔雀	动物
刺猬	动物
牛仔裤	服装
格子衬衫	服装
雨衣	生活用品
猫和老鼠	动画片
神奇宝贝	动画片
奥特曼	动画片
葫芦娃	动画片
蜡笔小新	动画片
樱桃小丸子	动画片
海绵宝宝	动画片
天线宝宝	动画片
喜羊羊和灰太狼	动画片
啤酒肚	身体状态
